Young T & Bugsey	6M6XXCcO5gI68XpIlrUL3Z	grime|uk drill|uk hip hop
The Weeknd	1Xyo4u8uXC1ZmMpatF05PJ	canadian contemporary r&b|canadian pop|pop
J Balvin	1vyhD5VmyZ7KMfW5gqLgo5	latin|reggaeton
Låpsley	27ze6hCgfr3HcDZAHY60pg	electropop|gauze pop|indie r&b|indietronica|vapor soul
The Lumineers	16oZKvXb6WkQlVAjwo2Wbg	folk-pop|modern rock|stomp and holler
Big Tobz	5mJzAPLj72Ifm4MdYS08uK	uk hip hop
St Francis Hotel	5ovQJMniNkE6D4Bwxxqin9	no_genre
Alexis Ffrench	58R31AvN8JMHM7xkNpVLjX	calming instrumental|classify|focus|neo-classical
Tove Lo	4NHQUGzhtTLFvgF5SZesLK	dance pop|electropop|metropopolis|pop|post-teen pop|swedish electropop|swedish pop|swedish synthpop
Baxter Dury	0EgHhNmWcjusA7F2heSD0O	chamber psych|electronica|french indie pop|french indietronica
Niall Horan	1Hsdzj7Dlq2I7tHP7501T4	dance pop|pop|post-teen pop
Four Tet	7Eu1txygG6nJttLHbZdQOh	alternative dance|electronica|folktronica|indie soul|indietronica|intelligent dance music|new rave
Circa Waves	6hl5k4gLl1p3sjhHcb57t2	english indie rock|indie surf|liverpool indie|modern alternative rock|modern rock|rock
Porridge Radio	4vAQ4M7vgItwBtmBTgRu48	art pop|brighton indie|chamber psych|english indie rock|experimental pop|freak folk|garage psych|indie rock|uk post-punk revival
Jordan Mackampa	24WPEGLYPvEsmk4GSDFyST	indie anthem-folk
The Snuts	4AzAfQNuAyKOFG4DZMsdAo	modern alternative rock|modern rock|rock|scottish indie rock
The Lathums	6PXYvMeTixxDzYAYugMlbg	english indie rock|manchester indie
Yumi Zouma	4tPyCwWrsvZ8OKYl7QRavL	chillwave|christchurch indie|electropop|indie pop|indie poptimism|indie soul|indietronica|nz pop|shimmer pop|vapor soul
The Lottery Winners	0LLilNa5TUAaUwJwLyOf2b	english indie rock|manchester indie
Love Regenerator	05KDKIpxshxrB9BMewaCBW	no_genre
Calvin Harris	7CajNmpbOovFoOoasH2HaY	dance pop|edm|electro house|house|pop|progressive house|tropical house|uk dance
Childish Gambino	73sIBHcqh3Z3NyqHKZ7FOL	atl hip hop|hip hop|pop rap|rap
Conan Gray	4Uc8Dsxct0oMqx0P6i60ea	bedroom pop|indie pop|pop
Kelsea Ballerini	3RqBeV12Tt7A8xH3zBDDUF	contemporary country|pop|post-teen pop
Eliza & The Delusionals	5XOV5b7cxUgB9PcoLBn69l	australian indie rock
Foley	776HGV4QHksTaUaawD9DnE	nz pop
Jay Electronica	0TkqXdyWLsssJH7okthMPQ	alternative hip hop|conscious hip hop|hip hop|rap|southern hip hop|underground hip hop
Various Artists	0LyfQWJT6nXafLPZqxe9Of	no_genre
Jeremy Redmore	5mmgJNEz7e4BePqugnaRkC	no_genre
The Kite String Tangle	3D6cosC5ZOLCpRxt6T3XS7	aussietronica|australian hip hop|australian indie|australian pop|brisbane indie|indietronica|vapor soul
Love Fame Tragedy	04Ye3owBSFJF5hnYWHtq9Q	english indie rock
San Mei	4IbFFaRjnH3yZGDmFtVzwG	vapor pop
Lil Uzi Vert	4O15NlyKLIASxsJ0PrXPfz	melodic rap|philly rap|rap
Die Antwoord	6urkHDoIVO1WO8vNIwcJmM	african rock|south african alternative|south african hip hop
Kennyon Brown	3igAFhxWKhbkKOsPtJVzn5	polynesian pop
Andy Garvey	7yGnQDpuwBRqBvat7gBGUl	australian house
TOKiMONSTA	3VwKSHAfgzV1DOHV0aANCI	chillwave|electra|indie soul|indietronica|vapor soul|vapor twitch|wonky
BOY	5TDH0epgb2OuD3osOUxejN	no_genre
Jack Harlow	2LIk90788K0zvyj2JJVwkJ	deep underground hip hop|pop rap|rap|trap|underground hip hop
John Legend	5y2Xq6xcjJb2jVM54GHK3t	neo mellow|neo soul|pop|r&b|urban contemporary
NLE Choppa	0ErzCpIMyLcjPiwT4elrtZ	memphis hip hop
Roddy Ricch	757aE44tKEUQEqRuT6GnEB	melodic rap
Justin Bieber	1uNFoZAHBGtllmzznpCI3s	canadian pop|pop|post-teen pop
R3HAB	6cEuCEZu7PAE9ZSzLLc2oQ	big room|dutch house|edm|electro house|pop|progressive electro house|tropical house
GATTÜSO	3PlRvQnVE3XAbtHUNc4nic	big room|edm|electro house|pop edm|tropical house
Nothing But Thieves	1kDGbuxWknIKx4FlgWxiSp	alternative pop rock|modern alternative rock|modern rock|rock
YBN Nahmir	3gGUMEwIX6XodWsYEvKSal	alabama rap|rap|trap|underground hip hop|vapor trap
G-Eazy	02kJSzxNuaWGqwubyUba0Z	hip hop|indie pop rap|pop rap|rap
Hayley Williams	6Rx1JKzBrSzoKQtmbVmBnM	pop punk
dvsn	7e1ICztHM2Sc4JNLxeMXYl	alternative r&b|canadian contemporary r&b|deep pop r&b|pop|r&b|trap soul|urban contemporary
Snoh Aalegra	1A9o3Ljt67pFZ89YtPPL5X	alternative r&b|indie r&b|indie soul|scandinavian r&b|swedish soul
Alkaline Trio	1aEYCT7t18aM3VvM6y8oVR	chicago punk|emo|pop punk|punk|screamo|skate punk
K CAMP	5bgfj5zUoWpyeVatGDjn6H	atl hip hop|hip hop|melodic rap|pop rap|rap|southern hip hop|trap|viral trap
Alana Springsteen	4TPT9nwjRvEV49q7f8p4fy	country pop
Filmore	0FvJm0y2eHw0aPkLLU3sIG	contemporary country|country pop
Rod Wave	45TgXXqMDdF8BkjA83OM7z	florida rap
Mt. Joy	69tiO1fG8VWduDl3ji2qhI	indie folk|indie pop|modern rock|stomp and holler
Dalex	0KPX4Ucy9dk82uj4GpKesn	latin|r&b en espanol
